10 10 10 15 15 15 15 15 15 15 15 15 15 15 15 15 15 15 15 15 15 15 15 15 15 15 15 15 15 15 15 15 15 15 15 17 17 17 17 17 17 17 17 15
10 10 10 15 10 10 10 10 10 10 10 10 10 10 10 10 10 10 10 10 10 10 10 10 15 10 10 19 19 19 19 19 19 19 19 16 11 11 11 11 11 11 16 15
10 10 10 15 10 10 10 10 10 10 10 10 10 10 10 10 10 10 10 10 10 10 10 10 18 10 10 10 10 10 10 10 10 10 10 16 11 11 11 11 11 11 16 15
10 10 10 15 10 10 10 10 10 10 10 10 10 10 10 10 10 10 10 10 10 10 10 10 15 10 10 19 10 10 10 10 10 10 10 16 17 17 17 17 17 17 17 15
10 10 10 15 10 10 10 10 10 10 10 10 10 10 10 10 10 10 10 10 10 10 10 10 15 10 10 19 19 19 19 19 19 19 19 19 19 19 19 19 19 10 19 15
10 10 10 15 10 10 10 10 10 10 10 10 10 10 10 10 10 10 10 10 10 10 10 10 19 10 10 19 10 10 10 10 10 10 19 10 10 10 10 10 10 10 10 15
10 10 10 15 10 10 10 10 10 10 10 10 10 10 10 10 10 10 10 10 10 10 10 10 19 10 10 10 10 10 10 10 10 10 19 10 10 10 10 10 10 10 10 15
10 10 10 15 10 10 10 10 10 10 10 10 10 10 10 10 10 10 10 10 10 10 10 10 19 10 10 19 10 10 10 10 10 10 19 10 10 10 10 10 10 10 10 15
10 10 10 15 10 10 10 10 10 10 10 10 10 10 10 10 19 19 19 19 19 19 19 19 19 10 10 19 19 19 19 19 10 19 19 10 10 10 10 10 10 10 10 15
10 10 10 15 10 10 10 10 10 10 10 10 10 10 10 10 19 10 10 10 10 10 10 10 19 10 10 10 10 10 10 10 10 10 10 10 10 10 19 19 19 10 19 15
10 10 10 15 10 10 10 10 10 10 10 10 10 10 10 10 19 10 10 10 10 10 10 10 19 10 10 15 15 15 15 15 15 19 19 19 19 19 10 10 10 10 10 15
10 10 10 15 10 10 10 10 10 10 10 10 10 10 10 10 19 10 10 10 10 10 10 10 19 10 10 15 10 10 10 10 15 10 10 10 10 10 19 10 10 10 10 15
10 10 10 15 10 10 10 10 10 10 10 10 10 10 10 10 19 10 10 10 10 10 10 10 19 10 10 10 10 10 10 10 15 10 10 10 10 10 19 10 10 10 10 15
10 10 10 15 10 10 10 10 10 10 10 10 11 18 18 18 19 10 10 10 10 10 10 10 19 10 10 15 15 15 15 15 15 10 10 10 10 10 10 10 10 10 10 15
10 10 10 15 10 10 10 10 10 10 10 10 11 18 18 18 19 19 10 19 10 19 19 19 19 10 10 15 10 10 10 19 10 10 10 10 10 19 19 19 19 19 19 15
10 10 10 15 10 10 10 10 10 10 10 10 11 18 18 18 10 10 10 10 10 15 15 15 15 10 10 10 10 10 10 10 19 19 19 10 10 19 10 10 10 10 10 15
10 10 10 15 10 10 10 10 10 10 10 10 11 18 15 10 10 10 10 10 10 10 10 10 10 10 10 15 10 10 10 10 10 10 19 10 10 19 10 10 10 10 10 15
10 10 10 15 10 10 10 10 10 10 10 10 11 18 18 10 10 10 10 10 10 10 10 10 10 10 10 15 10 10 10 10 10 10 19 10 10 10 10 10 10 10 10 15
10 10 10 15 10 10 10 10 10 10 10 10 11 18 17 17 17 17 17 17 17 17 17 17 17 10 10 15 10 10 10 10 10 10 19 10 10 19 19 19 19 19 19 15
10 10 10 15 10 10 10 10 10 10 10 10 11 18 16 11 11 11 11 11 11 11 11 11 12 10 10 15 15 15 15 15 15 10 19 10 10 10 10 10 10 10 10 15
10 10 10 15 10 10 10 10 10 10 10 10 11 18 16 11 11 11 11 11 11 11 11 11 12 10 10 10 10 10 10 10 10 10 10 10 10 15 10 10 10 10 10 15
10 10 10 15 10 10 10 10 10 10 10 10 11 18 16 11 11 11 11 11 11 11 11 11 12 10 10 16 17 17 17 17 17 17 17 17 17 17 17 10 10 10 10 15
10 10 10 15 10 10 10 10 10 10 10 10 11 18 16 11 11 11 11 11 11 11 11 11 12 10 10 16 11 11 11 11 11 11 11 11 11 11 11 12 10 10 10 15
10 10 10 15 10 10 10 10 10 10 10 10 11 18 16 11 11 11 11 11 11 11 11 11 12 10 10 16 11 11 11 11 11 11 11 11 11 11 11 11 12 10 10 15
10 10 10 15 10 10 10 10 10 10 10 10 11 18 16 11 11 11 11 11 11 11 11 11 12 10 10 16 11 11 11 11 11 11 11 11 11 11 11 11 11 12 10 15
10 10 10 15 10 10 10 10 10 10 10 10 11 18 16 11 11 11 11 11 11 11 11 11 12 10 10 16 11 11 11 11 11 11 11 11 11 11 11 11 11 12 10 15
10 10 10 15 10 10 10 10 10 10 10 10 11 18 16 11 11 11 11 11 11 11 11 11 12 10 10 16 11 11 11 11 11 11 11 11 11 11 11 11 11 12 10 15
10 10 10 15 10 10 10 10 10 10 10 10 11 18 16 13 13 13 13 13 13 13 13 13 12 10 10 16 11 11 11 11 11 11 11 11 11 11 11 11 11 12 10 15
10 10 10 15 10 15 15 15 15 15 15 15 15 18 18 18 18 18 18 18 18 18 18 10 10 10 10 16 11 11 11 11 11 11 11 11 11 11 11 11 11 12 10 15
10 10 10 15 10 10 10 10 10 10 10 10 10 10 10 10 10 10 10 10 10 10 10 10 10 10 10 16 11 11 11 11 11 11 11 11 11 11 11 11 11 12 10 15
10 10 10 15 10 10 10 10 16 17 17 17 17 17 17 17 17 17 17 17 17 17 17 17 17 10 10 16 11 11 11 11 11 11 11 11 11 11 11 11 11 12 10 15
10 10 10 15 10 10 10 10 16 11 11 11 11 11 11 11 11 11 11 11 11 11 11 11 12 10 10 16 13 13 13 13 13 13 13 13 13 13 13 13 13 12 10 15
10 10 10 15 10 10 10 10 16 11 11 11 11 11 11 11 11 11 11 11 11 11 11 11 12 10 10 10 10 10 15 15 15 15 15 15 15 15 15 15 10 10 10 15
10 10 10 15 10 10 10 10 16 11 11 11 11 11 11 11 11 11 11 11 11 11 11 11 12 10 10 15 10 10 10 10 10 10 10 10 10 10 10 10 10 10 10 15
10 10 10 15 10 10 10 10 16 11 11 11 11 11 11 11 11 11 11 11 11 11 11 11 12 10 10 15 10 14 14 10 10 15 15 15 15 15 15 15 15 10 10 15
10 10 10 15 10 10 10 10 16 11 11 11 11 11 11 11 11 11 11 11 11 11 11 11 12 10 10 11 11 11 11 11 11 11 11 11 11 11 11 11 11 10 10 15
10 10 10 15 10 10 10 10 16 11 11 11 11 11 11 11 11 11 11 11 11 11 11 11 12 10 10 11 11 11 11 11 11 11 11 11 11 11 11 11 11 10 10 15
10 10 10 15 10 10 10 10 16 11 11 11 11 11 11 11 11 11 11 11 11 11 11 11 12 10 10 10 10 10 10 18 10 10 10 10 10 10 10 10 10 10 10 15
10 10 10 15 10 10 10 10 16 13 13 13 13 13 13 13 13 13 13 13 13 13 13 13 12 10 10 10 10 10 10 10 10 10 10 10 10 10 10 10 10 10 10 15
10 10 10 15 10 10 10 10 10 10 10 10 10 10 10 10 10 10 10 10 10 10 10 10 10 10 10 10 10 10 10 10 10 10 10 10 10 10 10 10 10 10 10 15
10 10 10 15 10 10 10 10 10 10 10 10 10 10 10 10 10 10 10 10 10 10 10 10 10 10 10 10 10 10 10 10 10 10 10 10 10 10 10 10 10 10 10 15
10 10 10 15 15 15 15 15 15 15 15 15 15 15 15 15 15 15 15 15 15 15 15 15 15 15 15 15 15 15 15 15 15 15 15 15 15 15 15 15 15 15 15 15